C 119, 181, 254 
F 127, 204, 124 
NO ./texture/jungle/acacia_leaves_opaque.xpm
SO ./texture/jungle/jungle_leaves_opaque.xpm
WE ./texture/jungle/grass_block.xpm
EA ./texture/jungle/jungle_log_top.xpm


111111111111111111111111111
101010101010101010101010101
110000000000000000000000011
1010101010101N1010101010101
110000000000000000000000011
101010101010101010101010101
111111111111111111111111111
