F 113, 78, 65
C 82, 82, 82 
NO ./texture/mine/cracked_wall.xpm
EA ./texture/mine/furnace_front_on.xpm         
SO ./texture/mine/basalt.xpm     
WE ./texture/mine/diamond.xpm

1111111111111111111111111111111111111111111111111111111111111111
1000000000000000000000000000000000000000000000000000000000000011
100000000001000001011010011111000110011111P111111111110000000011
100000000111110001001010000001000110000000000000001  10000000011
1000000001111101110110111111110001100000000000000011110000000011
10000000000P000000001000000000000000000000E000000000000000000001
1111111111111111111111111111111111111111111111111111111111111111
