NO ./texture/jungle/acacia_leaves_opaque.xpm
SO ./texture/jungle/jungle_leaves_opaque.xpm
WE ./texture/jungle/grass_block.xpm
EA ./texture/jungle/jungle_log_top.xpm

F 00,252,0
C 100,100,100

1111111111111111111111111111111111111111111111111111111111111111111111111111
1000000000000000000000000000000000000000000000000000000000000000000000000001
10000000000000000000000000000000000000000000000000000000000000000000000000N1
1111111111111111111111111111111111111111111111111111111111111111111111111111