NO ./texture/jungle/acacia_leaves_opaque.xpm
SO ./texture/jungle/jungle_leaves_opaque.xpm
WE ./texture/jungle/grass_block.xpm
EA ./texture/jungle/jungle_log_top.xpm


F 206,206,206
C 119,181,254

 11111111111111111111111
1100000011110000000000E1
100000000000000000000011
11000000000000000000001
10000000000000000000001
10000000111100000000001
10000000111100000000001
11111111111111111111111