NO ./texture/jungle/acacia_leaves_opaque.xpm
SO ./texture/jungle/jungle_leaves_opaque.xpm
WE ./texture/jungle/grass_block.xpm
EA ./texture/jungle/jungle_log_top.xpm

F 124,252,0
C 0,0,0





        1111111111111111111111111
        1000000000110000000000001
        1011000001110000000000001
        1001000000000000000000001
111111111011000001110000000000001
100000000011000001110111111111111
11110111111111011100000010001
11110111111111011101010010001
110000001111110111000000P0001
10000000001 100011000000P0001
10000000001110001101010010E01
1100000111010101111101111000111
11110111 1110101 101111010001
11111111 1111111 111111111111




