NO ./texture/jungle/acacia_leaves_opaque.xpm
SO ./texture/jungle/jungle_leaves_opaque.xpm
WE ./texture/jungle/grass_block.xpm
EA ./texture/jungle/jungle_log_top.xpm

F 206,206,206
C 119,181,254

 11111111111111111111111
110000001111000000000001
100000000100000000000011
110000000P0000000000001
10000000010000000000001
1000000011110000W000001
10000000111100000000001
11111111111111111111111